   ###
  ## # ####
 ##  ###  #
## $      #
#   @$ #  #
### $###  #
  #  #..  #
 ## ##.# ##
 #      ##
 #     ##
 #######
;1
###################
#   ...  @  ...   #
# $$$  #####  $$$ #
##   ###   ###   ##
 ##  #       ##  #
  ####        ####
;2 dfeazd
###########
#@$      .#
###########
;3

